"date","Total Confirmed Hospitalizations","Total Confirmed ICU","Total Confirmed and Probable ICU","Total Confirmed Non-ICU","COVID-19 Percent ICU Utilization","Total Percent ICU Utilization","Facilities using prior day data"
2020-04-24,85,45,54,40,12,63,1
2020-04-25,91,47,57,44,12,61,0
2020-04-26,96,46,54,50,12,59,0
2020-04-27,90,47,57,43,12,55,0
2020-04-28,89,42,52,47,11,61,0
2020-04-29,89,43,58,46,13,60,0
2020-04-30,91,47,59,44,13,58,6
2020-05-01,86,47,57,39,12,58,1
2020-05-02,90,43,54,47,12,54,0
2020-05-03,99,51,53,48,12,49,0
2020-05-04,96,48,55,48,12,52,5
2020-05-05,90,50,57,40,12,62,1
2020-05-06,88,52,58,36,13,60,1
2020-05-07,86,52,62,34,14,63,1
2020-05-08,90,54,63,36,14,60,0
2020-05-09,88,55,59,33,13,59,1
2020-05-10,89,51,61,38,13,58,0
2020-05-11,94,51,66,43,14,57,1
2020-05-12,95,52,62,43,14,66,7
2020-05-13,98,56,71,42,16,61,0
2020-05-14,93,48,68,45,15,60,1
2020-05-15,100,51,62,49,14,66,0
2020-05-16,97,50,60,47,13,65,0
2020-05-17,92,50,58,42,13,60,1
2020-05-18,93,48,63,45,14,62,2
2020-05-19,96,50,60,46,13,67,0
2020-05-20,104,54,59,50,13,67,1
2020-05-21,47,29,33,18,10,67,0
2020-05-22,98,51,56,47,12,65,1
2020-05-23,91,51,58,40,13,63,0
2020-05-24,92,49,58,43,13,61,0
2020-05-25,92,46,54,46,12,60,0
2020-05-26,93,49,57,44,12,60,0
2020-05-27,91,44,50,47,11,68,0
2020-05-28,94,43,52,51,11,69,1
2020-05-29,91,45,52,46,11,69,0
2020-05-30,88,43,48,45,11,66,0
2020-05-31,100,42,47,58,10,64,1
2020-06-01,104,48,60,56,13,63,0
2020-06-02,104,52,60,52,13,65,0
2020-06-03,109,56,70,53,15,68,0
2020-06-04,105,55,57,50,12,66,0
2020-06-05,106,56,65,50,14,70,0
2020-06-06,112,62,77,50,17,69,0
2020-06-07,105,64,76,41,17,68,1
2020-06-08,117,66,84,51,18,64,2
2020-06-09,119,68,81,51,18,68,1
2020-06-10,110,62,72,48,16,67,0
2020-06-11,116,63,73,53,16,67,0
2020-06-12,124,69,76,55,17,70,3
2020-06-13,129,70,74,59,16,70,0
2020-06-14,136,65,77,71,17,61,2
2020-06-15,135,60,72,75,16,61,1
2020-06-16,141,60,72,81,16,62,0
2020-06-17,138,61,76,77,17,65,2
2020-06-18,136,60,62,76,14,65,3
2020-06-19,153,68,71,85,16,67,2
2020-06-20,153,60,66,93,14,65,0
2020-06-21,154,60,68,94,15,63,1
2020-06-22,144,70,76,74,17,66,0
2020-06-23,147,71,79,76,17,70,0
2020-06-24,155,74,87,81,19,69,0
2020-06-25,162,75,82,87,18,69,1
2020-06-26,171,68,77,103,17,65,1
2020-06-27,175,75,81,100,18,70,2
2020-06-28,179,75,80,104,18,67,2
2020-06-29,190,78,85,112,19,67,3
2020-06-30,176,78,88,98,19,69,3
2020-07-01,167,76,82,91,18,71,2
2020-07-02,170,81,88,89,19,72,0
2020-07-03,177,86,96,91,21,75,0
2020-07-04,168,81,90,87,20,70,1
2020-07-05,180,81,82,99,18,66,0
2020-07-06,185,83,88,102,19,66,2
2020-07-07,190,76,77,114,17,71,0
2020-07-08,169,74,80,95,18,71,1
2020-07-09,170,77,84,93,18,70,0
2020-07-10,188,81,89,107,19,74,0
2020-07-11,194,81,90,113,20,74,0
2020-07-12,192,83,93,109,20,70,0
2020-07-13,163,75,90,88,20,68,0
2020-07-14,187,76,86,111,19,71,0
2020-07-15,182,78,82,104,18,73,1
2020-07-16,177,85,89,92,20,77,2
2020-07-17,170,83,91,87,20,75,2
2020-07-18,182,93,101,89,23,69,1
2020-07-19,183,97,102,86,23,66,1
2020-07-20,164,88,97,76,22,69,0
2020-07-21,174,85,91,89,20,67,2
2020-07-22,190,90,97,100,22,73,1
2020-07-23,205,91,96,114,21,75,2
2020-07-24,182,73,78,109,17,71,0
2020-07-25,180,73,78,107,17,66,1
2020-07-26,179,75,79,104,18,64,0
2020-07-27,182,81,85,101,19,67,0
2020-07-28,180,79,83,101,19,75,1
2020-07-29,184,78,82,106,18,76,0
2020-07-30,184,76,80,108,18,72,1
2020-07-31,191,78,87,113,19,73,3
2020-08-01,186,79,85,107,19,74,0
2020-08-02,186,79,83,107,18,71,0
2020-08-03,163,78,83,85,18,67,2
2020-08-04,170,76,81,94,18,71,2
2020-08-05,176,76,79,100,17,70,0
2020-08-06,179,77,81,102,18,70,3
2020-08-07,169,71,73,98,16,69,0
2020-08-08,173,72,77,101,17,69,1
2020-08-09,174,75,82,99,18,67,1
2020-08-10,175,77,81,98,18,65,1
2020-08-11,181,74,79,107,17,70,1
2020-08-12,167,67,70,100,15,73,1
2020-08-13,155,63,69,92,15,72,3
2020-08-14,155,61,64,94,14,70,2
2020-08-15,147,60,66,87,14,69,2
2020-08-16,123,62,67,61,15,66,1
2020-08-17,123,59,64,64,14,66,1
2020-08-18,127,60,65,67,14,67,0
2020-08-19,125,56,58,69,13,72,0
2020-08-20,115,55,58,60,13,71,1
2020-08-21,118,50,51,68,11,69,1
2020-08-22,132,52,54,80,12,72,1
2020-08-23,123,50,51,73,11,70,0
2020-08-24,110,41,44,69,10,71,2
2020-08-25,106,37,39,69,9,69,2
2020-08-26,114,42,44,72,10,68,2
2020-08-27,112,45,47,67,10,69,0
2020-08-28,112,47,51,65,11,68,1
2020-08-29,114,44,49,70,11,69,1
2020-08-30,114,44,46,70,10,62,1
2020-08-31,115,43,47,72,10,62,1
2020-09-01,113,43,47,70,10,68,4
2020-09-02,101,42,44,59,10,70,3
2020-09-03,108,48,50,60,11,75,1
2020-09-04,97,46,49,51,11,75,0
2020-09-05,99,45,48,54,11,67,1
2020-09-06,103,39,40,64,9,67,1
2020-09-07,102,37,43,65,9,66,1
2020-09-08,104,41,46,63,10,65,2
2020-09-09,106,42,50,64,11,72,2
2020-09-10,110,43,57,67,12,73,1
2020-09-11,105,44,46,61,10,76,1
2020-09-12,115,47,49,68,11,75,2
2020-09-13,117,47,48,70,11,69,1
2020-09-14,113,45,48,68,11,72,2
2020-09-15,107,49,51,58,11,73,1
2020-09-16,109,50,51,59,11,74,0
2020-09-17,114,48,54,66,12,77,2
2020-09-18,119,47,50,72,11,76,0
2020-09-19,128,56,59,72,13,76,1
2020-09-20,132,60,64,72,14,75,0
2020-09-21,141,60,63,81,14,67,1
2020-09-22,152,63,65,89,14,74,3
2020-09-23,168,73,75,95,16,74,0
2020-09-24,162,72,73,90,16,74,1
2020-09-25,165,74,75,91,16,78,1
2020-09-26,167,75,76,92,17,76,0
2020-09-27,153,65,67,88,15,70,0
2020-09-28,163,68,70,95,15,66,1
2020-09-29,177,70,76,107,17,72,2
2020-09-30,181,71,76,110,17,76,3
2020-10-01,167,65,68,102,15,75,0
2020-10-02,151,57,59,94,13,77,2
2020-10-03,153,65,69,88,16,80,4
2020-10-04,150,64,66,86,15,75,0
2020-10-05,176,71,75,105,17,73,4
2020-10-06,190,77,78,113,18,79,2
2020-10-07,201,76,79,125,17,78,0
2020-10-08,206,76,80,130,18,76,2
2020-10-09,196,78,81,118,18,74,0
2020-10-10,205,82,86,123,19,70,4
2020-10-11,205,78,79,127,17,65,1
2020-10-12,217,84,86,133,19,73,2
2020-10-13,222,84,87,138,19,76,1
2020-10-14,236,86,92,150,20,75,2
2020-10-15,244,86,90,158,20,78,2
2020-10-16,248,87,91,161,20,78,2
2020-10-17,238,92,99,146,22,75,1
2020-10-18,245,92,94,153,21,74,1
2020-10-19,250,95,98,155,21,75,2
2020-10-20,261,101,106,160,23,79,1
2020-10-21,266,100,101,166,22,80,1
2020-10-22,271,101,103,170,22,81,1
2020-10-23,259,99,100,160,22,79,3
2020-10-24,263,110,114,153,25,83,3
2020-10-25,239,96,98,143,22,73,0
2020-10-26,259,108,113,151,25,74,2
2020-10-27,268,112,116,156,26,80,1
2020-10-28,269,111,116,158,26,75,2
2020-10-29,267,123,128,144,28,85,0
2020-10-30,263,118,122,145,27,81,2
2020-10-31,277,115,117,162,26,79,1
2020-11-01,300,128,133,172,29,76,0
2020-11-02,317,135,140,182,31,78,1
2020-11-03,324,139,143,185,32,83,2
2020-11-04,330,148,153,182,34,83,1
2020-11-05,347,157,164,190,36,83,2
2020-11-06,345,150,153,195,34,82,2
2020-11-07,366,158,165,208,36,81,3
2020-11-08,364,163,169,201,37,82,3
2020-11-09,376,167,169,209,37,82,2
2020-11-10,373,165,166,208,37,85,2
2020-11-11,386,170,172,216,38,89,0
2020-11-12,382,161,162,221,36,89,2
2020-11-13,390,163,165,227,36,89,2
2020-11-14,386,156,160,230,35,89,0
2020-11-15,405,167,172,238,38,88,1
2020-11-16,399,162,169,237,38,89,0
2020-11-17,431,172,176,259,39,90,3
2020-11-18,409,149,152,260,33,92,4
2020-11-19,429,151,158,278,35,94,1
2020-11-20,441,160,166,281,36,96,2
2020-11-21,425,163,168,262,37,93,2
2020-11-22,441,170,174,271,38,89,1
2020-11-23,445,177,184,268,40,84,2
2020-11-24,448,181,187,267,41,88,1
2020-11-25,460,178,183,282,40,92,2
2020-11-26,476,184,186,292,41,89,1
2020-11-27,470,180,181,290,40,83,0
2020-11-28,454,189,195,265,43,87,2
2020-11-29,461,186,192,275,42,90,1
2020-11-30,473,184,188,289,41,85,2
2020-12-01,462,180,182,282,41,87,7
2020-12-02,486,181,183,305,40,89,1
2020-12-03,475,177,181,298,40,88,0
2020-12-04,506,190,196,316,43,94,1
2020-12-05,493,195,199,298,44,96,0
2020-12-06,487,197,200,290,44,91,1
2020-12-07,479,196,199,283,44,91,0
2020-12-08,481,197,197,284,43,94,2
2020-12-09,450,190,196,260,42,95,1
2020-12-10,460,189,198,271,43,97,3
2020-12-11,443,190,193,253,42,102,5
2020-12-12,438,196,197,242,43,102,2
2020-12-13,443,189,190,254,41,93,2
2020-12-14,433,180,187,253,41,93,1
2020-12-15,437,185,187,252,41,98,3
2020-12-16,446,181,184,265,40,101,2
2020-12-17,441,179,181,262,39,100,4
2020-12-18,453,187,190,266,41,104,4
2020-12-19,448,176,178,272,39,98,4
2020-12-20,443,165,167,278,36,90,3
2020-12-21,432,168,174,264,38,91,2
2020-12-22,455,167,172,288,37,91,3
2020-12-23,444,155,158,289,34,92,3
2020-12-24,418,146,151,272,33,87,3
2020-12-25,384,147,156,237,34,83,6
2020-12-26,388,143,152,245,33,83,2
2020-12-27,393,140,149,253,32,82,2
2020-12-28,413,142,149,271,33,85,1
2020-12-29,399,134,141,265,31,87,3
2020-12-30,413,138,149,275,33,87,2
2020-12-31,397,132,138,265,30,87,4
2021-01-01,379,135,143,244,32,85,3
2021-01-02,372,137,149,235,33,86,1
2021-01-03,376,140,150,236,33,86,1
2021-01-04,406,150,158,256,35,86,2
2021-01-05,392,165,173,227,38,89,1
2021-01-06,391,156,162,235,35,88,2
2021-01-07,413,167,175,246,38,92,2
2021-01-08,402,154,161,248,35,93,2
2021-01-09,389,160,163,229,35,90,2
2021-01-10,407,163,169,244,37,88,2
2021-01-11,429,162,170,267,37,89,0
2021-01-12,441,164,169,277,37,93,2
2021-01-13,439,165,171,274,37,97,1
2021-01-14,449,175,181,274,39,95,1
2021-01-15,451,191,199,260,44,98,2
2021-01-16,436,190,195,246,43,101,3
2021-01-17,456,186,196,270,43,94,3
2021-01-18,461,183,194,278,43,91,0
2021-01-19,448,182,189,266,42,91,1
2021-01-20,434,179,184,255,41,96,2
2021-01-21,392,170,175,222,39,92,1
2021-01-22,379,164,171,215,38,91,1
2021-01-23,370,157,165,213,36,91,2
2021-01-24,371,149,159,222,35,88,1
2021-01-25,365,141,150,224,33,86,2
2021-01-26,350,138,142,212,32,89,6
2021-01-27,355,143,148,212,33,90,2
2021-01-28,350,131,138,219,31,91,2
2021-01-29,327,119,126,208,28,89,2
2021-01-30,311,110,119,201,27,84,1
2021-01-31,313,109,115,204,25,82,1
2021-02-01,307,111,118,196,26,79,4
2021-02-02,280,105,119,175,26,79,1
2021-02-03,291,110,124,181,27,78,2
2021-02-04,271,102,111,169,24,80,2
2021-02-05,272,104,117,168,25,84,3
2021-02-06,264,103,111,161,24,86,2
2021-02-07,256,101,109,155,24,78,1
2021-02-08,254,110,115,144,25,77,4
2021-02-09,258,116,119,142,26,84,3
2021-02-10,254,110,113,144,24,88,3
2021-02-11,249,103,106,146,23,86,2
2021-02-12,241,99,102,142,22,84,3
2021-02-13,229,96,99,133,21,81,3
2021-02-14,221,93,97,128,21,79,1
2021-02-15,220,94,97,126,21,75,5
2021-02-16,211,88,90,123,20,76,2
2021-02-17,209,92,95,117,21,78,2
2021-02-18,209,92,94,117,20,82,3
2021-02-19,198,88,90,110,20,81,5
2021-02-20,196,90,94,106,20,76,3
2021-02-21,191,86,89,105,19,72,0
2021-02-22,200,85,87,115,19,72,3
2021-02-23,190,84,85,106,19,78,1
2021-02-24,190,84,86,106,19,77,3
2021-02-25,197,88,91,109,20,77,3
2021-02-26,187,84,87,103,19,76,3
2021-02-27,169,78,78,91,17,74,3
2021-02-28,183,81,82,102,18,68,0
2021-03-01,179,83,84,96,18,70,3
2021-03-02,175,82,86,93,19,75,4
2021-03-03,164,78,84,86,18,74,4
2021-03-04,163,70,74,93,16,71,4
2021-03-05,155,68,70,87,15,75,2
2021-03-06,156,65,66,91,15,75,3
2021-03-07,162,67,68,95,15,72,3
2021-03-08,151,64,68,87,15,66,3
2021-03-09,145,63,66,82,15,71,1
2021-03-10,144,59,64,85,14,71,4
2021-03-11,152,56,59,96,13,72,1
2021-03-12,124,50,53,74,12,73,3
2021-03-13,141,52,53,89,12,74,1
2021-03-14,139,49,53,90,12,68,0
2021-03-15,140,48,49,92,11,68,3
2021-03-16,147,52,53,95,12,75,1
2021-03-17,150,54,55,96,12,75,2
2021-03-18,139,50,51,89,11,77,1
2021-03-19,119,47,47,72,10,79,2
2021-03-20,119,45,47,74,10,74,2
2021-03-21,106,42,46,64,10,65,1
2021-03-22,105,43,46,62,10,66,2
2021-03-23,103,44,45,59,10,72,0
2021-03-24,107,42,44,65,10,74,5
2021-03-25,105,42,44,63,10,73,7
2021-03-26,108,46,49,62,11,70,2
2021-03-27,117,48,50,69,11,69,2
2021-03-28,118,46,47,72,10,65,2
2021-03-29,105,46,47,59,10,63,3
2021-03-30,106,47,47,59,10,65,2
2021-03-31,107,45,45,62,10,69,2
2021-04-01,110,41,42,69,9,66,1
2021-04-02,100,38,40,62,9,70,2
2021-04-03,93,39,39,54,9,69,3
2021-04-04,98,41,44,57,10,67,3
2021-04-05,104,43,46,61,10,69,1
2021-04-06,112,49,52,63,11,73,1
2021-04-07,107,45,46,62,10,73,1
2021-04-08,111,47,48,64,11,71,2
2021-04-09,117,47,48,70,11,70,2
2021-04-10,106,53,54,53,12,70,1
2021-04-11,101,53,56,48,12,70,1
2021-04-12,104,50,52,54,11,67,3
2021-04-13,120,51,54,69,12,75,0
2021-04-14,121,49,50,72,11,76,2
2021-04-15,122,52,53,70,12,77,1
2021-04-16,106,47,51,59,11,77,2
2021-04-17,110,51,56,59,12,76,1
2021-04-18,110,48,51,62,11,68,2
2021-04-19,108,49,50,59,11,63,0
2021-04-20,116,52,54,64,12,64,2
2021-04-21,106,43,48,63,11,75,0
2021-04-22,113,55,57,58,13,76,1
2021-04-23,119,55,57,64,13,71,1
2021-04-24,117,54,58,63,13,72,2
2021-04-25,110,59,61,51,13,71,0
2021-04-26,112,57,59,55,13,69,2
2021-04-27,130,61,62,69,14,75,0
2021-04-28,121,59,59,62,13,77,3
2021-04-29,119,62,63,57,14,77,2
2021-04-30,111,52,52,59,11,75,0
2021-05-01,109,52,52,57,11,71,2
2021-05-02,108,50,50,58,11,67,3
2021-05-03,117,50,51,67,11,71,3
2021-05-04,126,57,57,69,13,74,0
2021-05-05,117,54,54,63,12,77,2
2021-05-06,106,49,50,57,11,75,1
2021-05-07,105,50,51,55,11,75,1
2021-05-08,107,53,54,54,12,70,2
2021-05-09,112,52,52,60,11,68,3
2021-05-10,117,52,54,65,12,70,1
2021-05-11,55,23,24,32,5,74,1
2021-05-12,128,47,48,81,11,75,1
2021-05-13,121,39,40,82,9,73,1
2021-05-14,120,44,44,76,10,74,1
2021-05-15,128,43,43,85,9,74,3
2021-05-16,126,44,45,82,10,72,9
2021-05-17,110,48,52,62,11,72,0
2021-05-18,108,49,55,59,12,82,1
2021-05-19,114,50,51,64,11,79,2
2021-05-20,112,49,49,63,11,80,3
2021-05-21,103,45,47,58,10,77,2
2021-05-22,108,38,38,70,8,76,2
2021-05-23,111,44,45,67,10,71,2
2021-05-24,114,45,46,69,10,69,2
2021-05-25,120,49,50,71,11,72,3
2021-05-26,110,46,47,64,10,76,3
2021-05-27,117,47,50,70,11,76,2
2021-05-28,112,46,46,66,10,73,4
2021-05-29,103,45,45,58,10,72,2
2021-05-30,109,45,45,64,10,68,2
2021-05-31,110,43,44,67,10,66,5
2021-06-01,105,47,48,58,11,68,3
2021-06-02,111,47,48,64,11,75,3
2021-06-03,109,46,48,63,11,76,2
2021-06-04,109,49,52,60,11,77,3
2021-06-05,99,45,46,54,10,73,2
2021-06-06,97,44,44,53,10,69,2
2021-06-07,114,49,49,65,11,70,3
2021-06-08,126,47,47,79,10,78,2
2021-06-09,130,49,49,81,11,79,2
2021-06-10,134,49,52,85,11,78,3
2021-06-11,135,50,51,85,11,76,2
2021-06-12,125,48,49,77,11,78,3
2021-06-13,127,48,48,79,11,77,3
2021-06-14,120,46,47,74,10,75,2
2021-06-15,121,49,51,72,11,81,2
2021-06-16,133,53,53,80,12,83,3
2021-06-17,130,52,52,78,11,82,2
2021-06-18,125,55,58,70,13,85,2
2021-06-19,119,56,59,63,13,81,3
2021-06-20,115,52,53,63,12,75,4
2021-06-21,129,58,59,71,13,74,2
2021-06-22,134,57,59,77,13,80,3
2021-06-23,160,48,50,112,11,80,2
2021-06-24,168,52,53,116,12,79,3
2021-06-25,169,50,51,119,11,74,2
2021-06-26,180,56,57,124,13,72,4
2021-06-27,188,59,59,129,13,70,4
2021-06-28,200,68,69,132,15,75,1
2021-06-29,209,69,71,140,16,82,3
2021-06-30,213,67,69,146,15,82,2
2021-07-01,206,73,74,133,16,83,1
2021-07-02,217,73,73,144,16,82,2
2021-07-03,211,83,84,128,19,79,2
2021-07-04,210,79,80,131,18,73,4
2021-07-05,223,76,76,147,17,72,2
2021-07-06,176,76,78,100,17,73,1
2021-07-07,184,79,79,105,17,82,0
2021-07-08,182,82,82,100,18,82,2
2021-07-09,181,81,82,100,18,80,2
2021-07-10,169,74,75,95,17,79,4
2021-07-11,168,75,77,93,17,73,2
2021-07-12,182,78,78,104,17,73,4
2021-07-13,192,85,86,107,19,79,1
2021-07-14,207,86,86,121,19,83,2
2021-07-15,226,92,93,134,21,86,2
2021-07-16,230,95,97,135,21,83,2
2021-07-17,223,97,99,126,22,86,2
2021-07-18,221,102,103,119,23,79,1
2021-07-19,235,104,108,131,24,77,2
2021-07-20,229,103,104,126,23,83,0
2021-07-21,233,109,111,124,25,88,0
2021-07-22,237,113,113,124,25,87,2
2021-07-23,251,122,122,129,27,86,3
2021-07-24,259,121,122,138,27,84,3
2021-07-25,267,119,123,148,27,84,3
2021-07-26,275,124,125,151,28,84,3
2021-07-27,287,135,136,152,30,86,3
2021-07-28,288,135,136,153,30,89,0
2021-07-29,286,132,134,154,30,90,4
2021-07-30,293,126,127,167,28,88,2
2021-07-31,301,143,145,158,32,87,3
2021-08-01,295,141,144,154,32,83,3
2021-08-02,319,146,148,173,33,83,3
2021-08-03,304,143,145,161,32,84,2
2021-08-04,309,145,146,164,32,82,2
2021-08-05,285,136,137,149,30,82,1
2021-08-06,292,128,130,164,29,81,0
2021-08-07,287,129,131,158,29,83,1
2021-08-08,292,133,134,159,30,79,1
2021-08-09,308,125,127,183,28,81,1
2021-08-10,315,124,125,191,28,83,1
2021-08-11,307,127,128,180,28,84,1
2021-08-12,275,112,113,163,33,86,1
2021-08-13,306,129,129,177,28,88,2
2021-08-14,295,133,135,162,30,85,2
2021-08-15,303,133,134,170,30,84,2
2021-08-16,311,132,132,179,29,82,3
2021-08-17,317,127,128,190,28,87,2
2021-08-18,319,138,139,181,31,91,2
2021-08-19,340,138,138,202,30,87,1
2021-08-20,347,144,146,203,32,89,2
2021-08-21,345,146,146,199,32,89,2
2021-08-22,356,146,146,210,32,85,4
2021-08-23,357,153,153,204,34,84,1
2021-08-24,383,154,155,229,34,87,1
2021-08-25,373,149,150,224,33,91,2
2021-08-26,362,154,155,208,34,89,1
2021-08-27,392,149,152,243,34,92,2
2021-08-28,372,153,153,219,34,92,3
2021-08-29,367,152,152,215,34,88,3
2021-08-30,377,157,158,220,35,89,1
2021-08-31,388,153,155,235,34,91,2
2021-09-01,392,153,153,239,34,93,1
2021-09-02,399,154,154,245,34,94,1
2021-09-03,391,161,166,230,38,96,0
2021-09-04,378,158,159,220,36,94,3
2021-09-05,364,147,148,217,34,91,4
2021-09-06,369,144,144,225,33,89,3
2021-09-07,362,148,150,214,34,88,1
2021-09-08,388,165,166,223,38,92,2
2021-09-09,389,170,174,219,39,94,0
2021-09-10,390,176,178,214,40,97,2
2021-09-11,404,172,172,232,39,93,5
2021-09-12,424,182,184,242,42,92,4
2021-09-13,439,185,185,254,42,91,0
2021-09-14,423,180,182,243,41,96,2
2021-09-15,433,187,187,246,44,97,1
2021-09-16,434,183,183,251,41,96,1
2021-09-17,440,191,191,249,43,96,1
2021-09-18,439,190,190,249,43,94,5
2021-09-19,441,187,187,254,42,92,5
2021-09-20,430,183,183,247,41,92,2
2021-09-21,418,187,188,231,43,94,1
2021-09-22,440,196,197,244,44,96,1
2021-09-23,440,196,197,244,44,96,16
2021-09-24,440,196,197,244,44,96,16
2021-09-25,427,177,178,250,41,96,8
2021-09-26,428,177,178,251,41,93,8
2021-09-27,444,189,189,255,42,93,4
2021-09-28,362,147,147,215,33,95,1
2021-09-29,443,178,178,265,40,94,2
2021-09-30,457,179,179,278,41,93,0
2021-10-01,445,177,177,268,40,93,2
2021-10-02,427,180,180,247,41,93,5
2021-10-03,427,178,180,249,41,94,4
2021-10-04,437,186,186,251,42,96,1
2021-10-05,439,192,194,247,44,99,2
2021-10-06,431,194,196,237,44,100,3
2021-10-07,435,202,204,233,46,102,2
2021-10-08,435,187,187,248,42,98,1
2021-10-09,425,181,182,244,41,97,6
2021-10-10,425,180,181,245,41,96,4
2021-10-11,445,176,177,269,40,94,1
2021-10-12,433,177,177,256,40,95,1
2021-10-13,428,172,173,256,39,98,2
2021-10-14,418,173,175,245,40,95,2
2021-10-15,407,171,172,236,39,95,1
2021-10-16,392,159,160,233,36,91,4
2021-10-17,392,161,161,231,37,94,5
2021-10-18,406,166,166,240,38,90,2
2021-10-19,418,166,168,252,38,95,1
2021-10-20,430,164,165,266,37,99,3
2021-10-21,419,161,162,258,37,99,3
2021-10-22,404,163,164,241,37,101,5
2021-10-23,425,166,167,259,38,100,6
2021-10-24,401,165,165,236,37,100,9
2021-10-25,414,167,167,247,38,94,4
2021-10-26,428,172,172,256,39,97,3
2021-10-27,412,173,174,239,39,95,3
2021-10-28,420,176,177,244,40,101,3
2021-10-29,406,175,176,231,40,99,4
2021-10-30,407,172,172,235,39,94,6
2021-10-31,407,176,176,231,40,92,8
2021-11-01,407,182,183,225,41,93,5
2021-11-02,424,185,186,239,42,96,5
2021-11-03,442,185,185,257,42,95,6
2021-11-04,442,180,180,262,41,96,3
2021-11-05,415,176,176,239,40,94,3
2021-11-06,439,181,181,258,41,93,6
2021-11-07,438,176,176,262,40,91,5
2021-11-08,447,187,187,260,42,92,4
2021-11-09,443,185,185,258,42,95,3
2021-11-10,422,183,183,239,41,96,3
2021-11-11,406,183,183,223,41,98,2
2021-11-12,430,185,185,245,42,98,3
2021-11-13,420,173,173,247,39,97,8
2021-11-14,441,179,179,262,41,95,7
2021-11-15,440,182,182,258,41,94,5
2021-11-16,436,191,191,245,43,98,4
2021-11-17,430,190,190,240,43,102,4
2021-11-18,417,180,180,237,41,100,4
2021-11-19,413,179,179,234,41,98,3
2021-11-20,400,170,170,230,39,98,5
2021-11-21,407,176,176,231,40,93,5
2021-11-22,413,179,179,234,41,90,3
2021-11-23,406,174,174,232,40,95,2
2021-11-24,400,171,171,229,39,96,5
2021-11-25,392,177,177,215,41,92,8
2021-11-26,402,181,181,221,41,90,7
2021-11-27,406,179,179,227,41,93,7
2021-11-28,416,179,179,237,41,97,6
2021-11-29,412,174,174,238,40,96,5
2021-11-30,397,170,170,227,39,99,3
2021-12-01,394,168,168,226,38,95,2
2021-12-02,383,167,167,216,38,95,3
2021-12-03,377,158,158,219,36,97,5
2021-12-04,386,161,161,225,37,98,7
2021-12-05,398,170,172,228,39,98,6
2021-12-06,407,174,176,233,40,98,7
2021-12-07,406,167,169,239,38,98,5
2021-12-08,430,176,178,254,40,97,5
2021-12-09,417,176,176,241,40,99,4
2021-12-10,405,173,174,232,39,101,4
2021-12-11,395,172,172,223,39,98,5
2021-12-12,394,169,169,225,38,99,8
2021-12-13,387,166,166,221,38,99,5
2021-12-14,395,167,167,228,38,99,6
2021-12-15,393,161,161,232,37,96,7
2021-12-16,386,163,163,223,37,98,6
2021-12-17,364,159,159,205,37,98,6
2021-12-18,352,162,162,190,37,99,7
2021-12-19,348,161,161,187,37,99,8
2021-12-20,339,149,149,190,34,96,8
2021-12-21,353,147,147,206,33,98,6
2021-12-22,362,144,144,218,33,98,3
2021-12-23,352,149,149,203,34,96,6
2021-12-24,336,134,134,202,30,94,9
2021-12-25,350,145,145,205,33,94,7
2021-12-26,351,148,148,203,34,95,7
2021-12-27,357,150,150,207,34,96,6
2021-12-28,351,149,150,202,34,95,4
2021-12-29,348,150,150,198,34,96,5
2021-12-30,350,144,145,206,33,95,5
2021-12-31,362,146,146,216,33,95,7
2022-01-01,354,152,152,202,34,94,6
2022-01-02,354,148,148,206,34,90,9
2022-01-03,374,151,151,223,34,91,6
2022-01-04,383,152,152,231,34,95,5
2022-01-05,399,154,154,245,35,96,5
