"vaccine_date","Delivered","Vaccines Administered","People Fully Vaccinated","People Received at Least One Dose","People Received Booster Dose","Cumulative Vaccines Administered","Cumulative People Fully Vaccinated","Cumulative Deliveries","Cumulative People Received at Least One Dose","Cumulative People Received Booster Dose","Seven-day Average"
2020-12-14,2925,0,0,0,0,0,0,2925,0,0,NA
2020-12-15,6825,157,0,157,0,157,0,9750,157,0,NA
2020-12-16,0,481,0,481,0,638,0,9750,638,0,NA
2020-12-17,13650,2685,0,2685,0,3323,0,23400,3323,0,NA
2020-12-18,0,3283,0,3283,0,6606,0,23400,6606,0,NA
2020-12-19,0,961,1,960,0,7567,1,23400,7566,0,NA
2020-12-20,0,4,0,4,0,7571,1,23400,7570,0,NA
2020-12-21,1600,3921,0,3921,0,11492,1,25000,11491,0,1641.7
2020-12-22,5325,3036,0,3036,0,14528,1,30325,14527,0,2053
2020-12-23,55600,4404,0,4403,0,18932,1,85925,18930,0,2613.4
2020-12-24,0,1392,0,1392,0,20324,1,85925,20322,0,2428.7
2020-12-25,0,23,0,23,0,20347,1,85925,20345,0,1963
2020-12-26,0,534,0,534,0,20881,1,85925,20879,0,1902
2020-12-27,0,59,0,59,0,20940,1,85925,20938,0,1909.9
2020-12-28,21900,5972,0,5972,0,26912,1,107825,26910,0,2202.9
2020-12-29,6875,9850,0,9849,0,36762,1,114700,36759,0,3176.3
2020-12-30,33550,13017,0,13016,0,49779,1,148250,49775,0,4406.7
2020-12-31,0,6527,0,6527,0,56306,1,148250,56302,0,5140.3
2021-01-01,0,187,1,186,0,56493,2,148250,56488,0,5163.7
2021-01-02,0,1787,2,1785,0,58280,4,148250,58273,0,5342.7
2021-01-03,0,603,0,603,0,58883,4,148250,58876,0,5420.4
2021-01-04,16000,6965,302,6663,0,65848,306,164250,65539,0,5562.3
2021-01-05,13825,9836,557,9278,0,75684,863,178075,74817,0,5560.3
2021-01-06,19500,11646,546,11098,0,87330,1409,197575,85915,0,5364.4
2021-01-07,0,10849,2000,8847,0,98179,3409,197575,94762,0,5981.9
2021-01-08,16425,10478,1700,8776,0,108657,5109,214000,103538,0,7452
2021-01-09,0,2420,492,1927,0,111077,5601,214000,105465,0,7542.4
2021-01-10,0,886,0,886,0,111963,5601,214000,106351,0,7582.9
2021-01-11,4685,9343,2591,6751,0,121306,8192,218685,113102,0,7922.6
2021-01-12,47300,12468,1706,10758,0,133774,9898,265985,123860,0,8298.6
2021-01-13,10250,11609,2467,9139,0,145383,12365,276235,132999,0,8293.3
2021-01-14,975,10435,1344,9090,0,155818,13709,277210,142089,0,8234.1
2021-01-15,1775,14556,1798,12756,0,170374,15507,278985,154845,0,8816.7
2021-01-16,0,7119,157,6961,0,177493,15664,278985,161806,0,9488
2021-01-17,0,853,2,851,0,178346,15666,278985,162657,0,9483.3
2021-01-18,12425,3521,1112,2407,0,181867,16778,291410,165064,0,8651.6
2021-01-19,39400,12778,2811,9965,0,194645,19589,330810,175029,0,8695.9
2021-01-20,18025,15522,3954,11556,0,210167,23543,348835,186585,0,9254.9
2021-01-21,5700,13962,3585,10373,0,224129,27128,354535,196958,0,9758.7
2021-01-22,0,13329,3025,10301,0,237458,30153,354535,207259,0,9583.4
2021-01-23,0,6208,1077,5131,0,243666,31230,354535,212390,0,9453.3
2021-01-24,0,690,353,336,0,244356,31583,354535,212726,0,9430
2021-01-25,33625,7527,4612,2909,0,251883,36195,388160,215635,0,10002.3
2021-01-26,21400,14703,5705,8988,0,266586,41900,409560,224623,0,10277.3
2021-01-27,5775,18425,7794,10625,0,285011,49694,415335,235248,0,10692
2021-01-28,2750,17577,7783,9782,0,302588,57477,418085,245030,0,11208.4
2021-01-29,0,18774,8803,9964,0,321362,66280,418085,254994,0,11986.3
2021-01-30,0,7360,3263,4095,0,328722,69543,418085,259089,0,12150.9
2021-01-31,0,595,491,104,0,329317,70034,418085,259193,0,12137.3
2021-02-01,48250,10646,5962,4681,0,339963,75996,466335,263874,0,12582.9
2021-02-02,23950,17546,7991,9552,0,357509,83987,490285,273426,0,12989
2021-02-03,20875,18322,6636,11678,0,375831,90623,511160,285104,0,12974.3
2021-02-04,1175,21837,6548,15283,0,397668,97171,512335,300387,0,13582.9
2021-02-05,200,21550,10372,11170,0,419218,107543,512535,311557,0,13979.4
2021-02-06,0,8536,2776,5757,0,427754,110319,512535,317314,0,14147.4
2021-02-07,0,859,665,193,0,428613,110984,512535,317507,0,14185.1
2021-02-08,40750,11639,4625,7009,0,440252,115609,553285,324516,0,14327
2021-02-09,24775,16100,8013,8075,0,456352,123622,578060,332591,0,14120.4
2021-02-10,26150,20635,10826,9796,0,476987,134448,604210,342387,0,14450.9
2021-02-11,-70,25115,13449,11608,0,502102,147897,604140,353995,0,14919.1
2021-02-12,150,23805,13777,10012,0,525907,161674,604290,364007,0,15241.3
2021-02-13,-150,10661,6279,4379,0,536568,167953,604140,368386,0,15544.9
2021-02-14,150,343,215,127,0,536911,168168,604290,368513,0,15471.1
2021-02-15,24975,7099,3252,3839,0,544010,171420,629265,372352,0,14822.6
2021-02-16,2375,16395,7712,8676,0,560405,179132,631640,381028,0,14864.7
2021-02-17,12775,12000,5532,6443,0,572405,184664,644415,387471,0,13631.1
2021-02-18,14625,17326,9754,7561,0,589731,194418,659040,395032,0,12518.4
2021-02-19,1600,16649,10862,5772,0,606380,205280,660640,400804,0,11496.1
2021-02-20,0,8882,4364,4509,0,615262,209644,660640,405313,0,11242
2021-02-21,0,4542,1623,2917,0,619804,211267,660640,408230,0,11841.9
2021-02-22,63360,12035,6168,5850,0,631839,217435,724000,414080,0,12547
2021-02-23,35410,19887,9523,10337,0,651726,226958,759410,424417,0,13045.9
2021-02-24,28660,19924,7871,12044,0,671650,234829,788070,436461,0,14177.9
2021-02-25,28870,26756,13161,13522,0,698406,247990,816940,449983,0,15525
2021-02-26,4400,20911,9361,11540,0,719317,257351,821340,461523,0,16133.9
2021-02-27,0,14359,5227,9128,0,733676,262578,821340,470651,0,16916.3
2021-02-28,0,643,120,522,0,734319,262698,821340,471173,0,16359.3
2021-03-01,58400,17624,5643,11966,0,751943,268341,879740,483139,0,17157.7
2021-03-02,55310,23824,7418,16422,0,775767,275759,935050,499561,0,17720.1
2021-03-03,45160,23701,8195,16034,0,799468,283954,980210,515595,0,18259.7
2021-03-04,12220,31450,13966,21573,0,830918,297920,992430,537168,0,18930.3
2021-03-05,2340,26200,13355,17430,0,857118,311275,994770,554598,0,19685.9
2021-03-06,0,11361,5199,7034,0,868479,316474,994770,561632,0,19257.6
2021-03-07,0,1150,197,1072,0,869629,316671,994770,562704,0,19330
2021-03-08,62420,23361,9921,17605,0,892990,326592,1057190,580309,0,20149.6
2021-03-09,37200,31683,11259,22432,0,924673,337851,1094390,602741,0,21272.3
2021-03-10,42650,30470,10250,25708,0,955143,348101,1137040,628449,0,22239.3
2021-03-11,6120,35508,12223,24634,0,990651,360324,1143160,653083,0,22819
2021-03-12,4680,23380,10293,13899,0,1014031,370617,1147840,666982,0,22416.1
2021-03-13,0,12716,5159,8324,0,1026747,375776,1147840,675306,0,22609.7
2021-03-14,0,1817,878,1536,0,1028564,376654,1147840,676842,0,22705
2021-03-15,67090,21765,8451,14017,0,1050329,385105,1214930,690859,0,22477
2021-03-16,36900,28173,11722,17339,0,1078502,396827,1251830,708198,0,21975.6
2021-03-17,49890,25732,9819,18376,0,1104234,406646,1301720,726574,0,21298.7
2021-03-18,11230,32635,10272,23331,0,1136869,416918,1312950,749905,0,20888.3
2021-03-19,11700,23249,10135,13965,0,1160118,427053,1324650,763870,0,20869.6
2021-03-20,0,15044,6528,8843,0,1175162,433581,1324650,772713,0,21202.1
2021-03-21,0,2233,407,1865,0,1177395,433988,1324650,774578,0,21261.6
2021-03-22,64740,25163,10208,15313,0,1202558,444196,1389390,789891,0,21747
2021-03-23,32500,31619,12447,19704,0,1234177,456643,1421890,809595,0,22239.3
2021-03-24,57580,30858,12018,19815,0,1265035,468661,1479470,829410,0,22971.6
2021-03-25,14650,36633,14751,23038,0,1301668,483412,1494120,852448,0,23542.7
2021-03-26,9480,24918,10221,15350,0,1326586,493633,1503600,867798,0,23781.1
2021-03-27,0,13464,6526,7744,0,1340050,500159,1503600,875542,0,23555.4
2021-03-28,0,2035,844,1228,0,1342085,501003,1503600,876770,0,23527.1
2021-03-29,95220,28355,11512,17223,0,1370440,512515,1598820,893993,0,23983.1
2021-03-30,31300,39827,18939,22047,0,1410267,531454,1630120,916040,0,25155.7
2021-03-31,62940,43713,20065,25640,0,1453980,551519,1693060,941680,0,26992.1
2021-04-01,22930,40122,21337,22146,0,1494102,572856,1715990,963826,0,27490.6
2021-04-02,20560,31189,17784,17345,0,1525291,590640,1736550,981171,0,28386.4
2021-04-03,0,13894,6442,8540,0,1539185,597082,1736550,989711,0,28447.9
2021-04-04,0,2136,835,1511,0,1541321,597917,1736550,991222,0,28462.3
2021-04-05,100720,32505,18068,19619,0,1573826,615985,1837270,1010841,0,29055.1
2021-04-06,30400,39549,23022,21429,0,1613375,639007,1867670,1032270,0,29015.4
2021-04-07,53540,43310,21992,28797,0,1656685,660999,1921210,1061067,0,28957.9
2021-04-08,24350,46181,28929,24839,0,1702866,689928,1945560,1085906,0,29823.4
2021-04-09,12050,35282,22497,22283,0,1738148,712425,1957610,1108189,0,30408.1
2021-04-10,0,19335,12542,9157,0,1757483,724967,1957610,1117346,0,31185.4
2021-04-11,0,3300,1480,2196,0,1760783,726447,1957610,1119542,0,31351.7
2021-04-12,49900,28125,14760,16714,0,1788908,741207,2007510,1136256,0,30726
2021-04-13,59850,29248,16126,13104,0,1818156,757333,2067360,1149360,0,29254.4
2021-04-14,56500,30474,18377,12078,0,1848630,775710,2123860,1161438,0,27420.7
2021-04-15,18940,37307,21026,16234,0,1885937,796736,2142800,1177672,0,26153
2021-04-16,27270,29244,14716,14494,0,1915181,811452,2170070,1192166,0,25290.4
2021-04-17,0,15795,6663,9120,0,1930976,818115,2170070,1201286,0,24784.7
2021-04-18,0,2500,1211,1282,0,1933476,819326,2170070,1202568,0,24670.4
2021-04-19,12220,19734,10966,8743,0,1953210,830292,2182290,1211311,0,23471.7
2021-04-20,104090,31558,19005,12497,0,1984768,849297,2286380,1223808,0,23801.7
2021-04-21,43640,31885,19110,12741,0,2016653,868407,2330020,1236549,0,24003.3
2021-04-22,15200,32240,20440,11768,0,2048893,888847,2345220,1248317,0,23279.4
2021-04-23,25690,28544,16775,11762,0,2077437,905622,2370910,1260079,0,23179.4
2021-04-24,100,12801,7076,5744,0,2090238,912698,2371010,1265823,0,22751.7
2021-04-25,0,2378,1121,1257,0,2092616,913819,2371010,1267080,0,22734.3
2021-04-26,72738,22133,15021,7338,0,2114749,928840,2443748,1274418,0,23077
2021-04-27,36870,25959,15419,11046,0,2140708,944259,2480618,1285464,0,22277.1
2021-04-28,45910,30308,20805,10111,0,2171016,965064,2526528,1295575,0,22051.9
2021-04-29,17495,25403,15590,10712,0,2196419,980654,2544023,1306287,0,21075.1
2021-04-30,16740,24708,15152,10333,0,2221127,995806,2560763,1316620,0,20527.1
2021-05-01,0,12619,7916,5075,0,2233746,1003722,2560763,1321695,0,20501.1
2021-05-02,0,3223,2316,1004,0,2236969,1006038,2560763,1322699,0,20621.9
2021-05-03,57920,19672,14335,6038,0,2256641,1020373,2618683,1328737,0,20270.3
2021-05-04,36060,20137,14320,6861,0,2276778,1034693,2654743,1335598,0,19438.6
2021-05-05,54550,20150,13959,7224,0,2296928,1048652,2709293,1342822,0,17987.4
2021-05-06,8810,23472,16978,7498,0,2320400,1065630,2718103,1350320,0,17711.6
2021-05-07,23572,23379,17270,7379,0,2343779,1082900,2741675,1357699,0,17521.7
2021-05-08,0,10429,7287,3603,0,2354208,1090187,2741675,1361302,0,17208.9
2021-05-09,0,1887,1266,725,0,2356095,1091453,2741675,1362027,0,17018
2021-05-10,82860,12410,9616,3453,0,2368505,1101069,2824535,1365480,0,15980.6
2021-05-11,31440,16584,12108,5467,0,2385089,1113177,2855975,1370947,0,15473
2021-05-12,45206,16484,12477,4625,0,2401573,1125654,2901181,1375572,0,14949.3
2021-05-13,16134,20169,12715,8272,0,2421742,1138369,2917315,1383844,0,14477.4
2021-05-14,25420,24105,14915,10319,0,2445847,1153284,2942735,1394163,0,14581.1
2021-05-15,0,14877,7135,8405,0,2460724,1160419,2942735,1402568,0,15216.6
2021-05-16,0,2974,1207,1836,0,2463698,1161626,2942735,1404404,0,15371.9
2021-05-17,9214,17014,8439,9586,0,2480712,1170065,2951949,1413990,0,16029.6
2021-05-18,30718,18344,10138,9157,0,2499056,1180203,2982667,1423147,0,16281
2021-05-19,36700,17377,9577,8630,0,2516433,1189780,3019367,1431777,0,16408.6
2021-05-20,9910,19754,11785,9036,0,2536187,1201565,3029277,1440813,0,16349.3
2021-05-21,27552,20793,11252,10516,0,2556980,1212817,3056829,1451329,0,15876.1
2021-05-22,0,11834,6304,6180,0,2568814,1219121,3056829,1457509,0,15441.4
2021-05-23,0,2563,1036,1645,0,2571377,1220157,3056829,1459154,0,15382.7
2021-05-24,5742,13189,7213,6804,0,2584566,1227370,3062571,1465958,0,14836.3
2021-05-25,12521,13471,7780,6311,0,2598037,1235150,3075092,1472269,0,14140.1
2021-05-26,7600,13158,8501,5335,0,2611195,1243651,3082692,1477604,0,13537.4
2021-05-27,9376,14415,9359,5821,0,2625610,1253010,3092068,1483425,0,12774.7
2021-05-28,25160,13827,8564,6066,0,2639437,1261574,3117228,1489491,0,11779.6
2021-05-29,0,7358,4326,3413,0,2646795,1265900,3117228,1492904,0,11140.1
2021-05-30,0,1699,809,1004,0,2648494,1266709,3117228,1493908,0,11016.7
2021-05-31,0,1005,560,521,0,2649499,1267269,3117228,1494429,0,9276.1
2021-06-01,9360,10445,6270,4773,0,2659944,1273539,3126588,1499202,0,8843.9
2021-06-02,9510,8941,5571,4097,0,2668885,1279110,3136098,1503299,0,8241.4
2021-06-03,8536,11087,7611,4017,0,2679972,1286721,3144634,1507316,0,7766
2021-06-04,28090,13467,9160,4987,0,2693439,1295881,3172724,1512303,0,7714.6
2021-06-05,0,10559,8040,2900,0,2703998,1303921,3172724,1515203,0,8171.9
2021-06-06,0,2286,1588,770,0,2706284,1305509,3172724,1515973,0,8255.7
2021-06-07,6484,10370,6983,3901,0,2716654,1312492,3179208,1519874,0,9593.6
2021-06-08,610,9446,6480,3480,0,2726100,1318972,3179818,1523354,0,9450.9
2021-06-09,720,9234,6504,3183,0,2735334,1325476,3180538,1526537,0,9492.7
2021-06-10,5060,10861,7472,3847,0,2746195,1332948,3185598,1530384,0,9460.4
2021-06-11,8710,12985,9716,3760,0,2759180,1342664,3194308,1534144,0,9391.6
2021-06-12,0,7355,5499,2195,0,2766535,1348163,3194308,1536339,0,8933.9
2021-06-13,0,1765,1451,368,0,2768300,1349614,3194308,1536707,0,8859.4
2021-06-14,1746,9404,6731,3039,0,2777704,1356345,3196054,1539746,0,8721.4
2021-06-15,8210,8710,5825,3193,0,2786414,1362170,3204264,1542939,0,8616.3
2021-06-16,2612,7636,5123,2838,0,2794050,1367293,3206876,1545777,0,8388
2021-06-17,9416,8521,5762,3121,0,2802571,1373055,3216292,1548898,0,8053.7
2021-06-18,11540,8906,5933,3450,0,2811477,1378988,3227832,1552348,0,7471
2021-06-19,0,5007,3430,1854,0,2816484,1382418,3227832,1554202,0,7135.6
2021-06-20,0,1513,957,613,0,2817997,1383375,3227832,1554815,0,7099.6
2021-06-21,7230,5992,3261,3089,0,2823989,1386636,3235062,1557904,0,6612.1
2021-06-22,5824,6807,4283,3001,0,2830796,1390919,3240886,1560905,0,6340.3
2021-06-23,2068,6580,3835,3085,0,2837376,1394754,3242954,1563990,0,6189.4
2021-06-24,6640,6980,4137,3258,0,2844356,1398891,3249594,1567248,0,5969.3
2021-06-25,4391,7885,4779,3502,0,2852241,1403670,3253985,1570750,0,5823.4
2021-06-26,0,4568,2740,2071,0,2856809,1406410,3253985,1572821,0,5760.7
2021-06-27,0,1374,697,711,0,2858183,1407107,3253985,1573532,0,5740.9
2021-06-28,2790,6540,3643,3250,0,2864723,1410750,3256775,1576782,0,5819.1
2021-06-29,430,5666,3138,2871,0,2870389,1413888,3257205,1579653,0,5656.1
2021-06-30,4540,5600,3019,2865,0,2875989,1416907,3261745,1582518,0,5516.1
2021-07-01,7580,5932,3202,3105,0,2881921,1420109,3269325,1585623,0,5366.4
2021-07-02,7002,6808,3628,3628,0,2888729,1423737,3276327,1589251,0,5212.6
2021-07-03,0,2785,1369,1541,0,2891514,1425106,3276327,1590792,0,4957.9
2021-07-04,0,417,194,280,0,2891931,1425300,3276327,1591072,0,4821.1
2021-07-05,0,3319,1610,1875,0,2895250,1426910,3276327,1592947,0,4361
2021-07-06,-132,6017,3496,2840,0,2901267,1430406,3276195,1595787,0,4411.1
2021-07-07,3178,5832,3108,3112,0,2907099,1433514,3279373,1598899,0,4444.3
2021-07-08,2664,5892,3012,3267,0,2912991,1436526,3282037,1602166,0,4438.6
2021-07-09,17152,7152,3601,3942,0,2920143,1440127,3299189,1606108,0,4487.7
2021-07-10,0,3868,1825,2275,0,2924011,1441952,3299189,1608383,0,4642.4
2021-07-11,0,1396,618,830,0,2925407,1442570,3299189,1609213,0,4782.3
2021-07-12,100,6290,3106,3507,0,2931697,1445676,3299289,1612720,0,5206.7
2021-07-13,4192,5289,2606,2992,0,2936986,1448282,3303481,1615712,0,5102.7
2021-07-14,3692,5519,2667,3119,0,2942505,1450949,3307173,1618831,0,5058
2021-07-15,6402,5548,2662,3167,0,2948053,1453611,3313575,1621998,0,5008.9
2021-07-16,9758,6651,3224,3674,0,2954704,1456835,3323333,1625672,0,4937.3
2021-07-17,0,3701,1662,2193,0,2958405,1458497,3323333,1627865,0,4913.4
2021-07-18,0,1491,658,848,0,2959896,1459155,3323333,1628713,0,4927
2021-07-19,1050,6879,3087,4040,0,2966775,1462242,3324383,1632753,0,5011.1
2021-07-20,3180,5834,2570,3583,0,2972609,1464812,3327563,1636336,0,5089
2021-07-21,268,6209,2800,3666,0,2978818,1467612,3327831,1640002,0,5187.6
2021-07-22,18332,7172,2993,4519,0,2985990,1470605,3346163,1644521,0,5419.6
2021-07-23,3100,6416,2471,4164,0,2992406,1473076,3349263,1648685,0,5386
2021-07-24,0,3441,1453,2094,0,2995847,1474529,3349263,1650779,0,5348.9
2021-07-25,0,1532,449,1119,0,2997379,1474978,3349263,1651898,0,5354.7
2021-07-26,1320,7353,2900,4812,0,3004732,1477878,3350583,1656710,0,5422.4
2021-07-27,2214,6819,2630,4461,0,3011551,1480508,3352797,1661171,0,5563.1
2021-07-28,10404,6946,2687,4513,0,3018497,1483195,3363201,1665684,0,5668.4
2021-07-29,17640,7150,2786,4628,0,3025647,1485981,3380841,1670312,0,5665.3
2021-07-30,10300,9060,3636,5756,0,3034707,1489617,3391141,1676068,0,6043
2021-07-31,0,4824,1911,3043,0,3039531,1491528,3391141,1679111,0,6240.6
2021-08-01,0,2157,763,1420,0,3041688,1492291,3391141,1680531,0,6329.9
2021-08-02,1960,8463,3186,5516,0,3050151,1495477,3393101,1686047,0,6488.4
2021-08-03,4398,8024,3026,5293,0,3058175,1498503,3397499,1691340,0,6660.6
2021-08-04,1826,7721,2669,5291,0,3065896,1501172,3399325,1696631,0,6771.3
2021-08-05,25984,7610,2714,5081,0,3073506,1503886,3425309,1701712,0,6837
2021-08-06,11580,9321,3527,6049,0,3082827,1507413,3436889,1707761,0,6874.3
2021-08-07,0,5227,1950,3365,0,3088054,1509363,3436889,1711126,0,6931.9
2021-08-08,0,2440,869,1590,0,3090494,1510232,3436889,1712716,0,6972.3
2021-08-09,3192,9302,3614,5925,0,3099796,1513846,3440081,1718641,0,7092.1
2021-08-10,2660,7853,3118,4958,0,3107649,1516964,3442741,1723599,0,7067.7
2021-08-11,15480,7576,2891,4871,0,3115225,1519855,3458221,1728470,0,7047
2021-08-12,34840,8664,3292,5599,0,3123889,1523147,3493061,1734069,0,7197.6
2021-08-13,18680,11332,4052,7538,108,3135221,1527199,3511741,1741607,108,7484.9
2021-08-14,0,5903,1970,3808,212,3141124,1529169,3511741,1745415,320,7581.4
2021-08-15,0,2482,921,1435,137,3143606,1530090,3511741,1746850,457,7587.4
2021-08-16,7672,11091,3916,6833,636,3154697,1534006,3519413,1753683,1093,7843
2021-08-17,1386,9814,3582,5786,671,3164511,1537588,3520799,1759469,1764,8123.1
2021-08-18,28794,9716,3532,5652,715,3174227,1541120,3549593,1765121,2479,8428.9
2021-08-19,53630,9074,3435,5155,647,3183301,1544555,3603223,1770276,3126,8487.4
2021-08-20,31414,11050,4955,5631,654,3194351,1549510,3634637,1775907,3780,8447.1
2021-08-21,0,5861,2776,2882,257,3200212,1552286,3634637,1778789,4037,8441.1
2021-08-22,0,2419,1197,1118,109,3202631,1553483,3634637,1779907,4146,8432.1
2021-08-23,28672,9977,4413,5121,641,3212608,1557896,3663309,1785028,4787,8273
2021-08-24,7390,9057,3928,4869,539,3221665,1561824,3670699,1789897,5326,8164.9
2021-08-25,14970,8677,3850,4429,569,3230342,1565674,3685669,1794326,5895,8016.4
2021-08-26,27106,8699,3898,4377,595,3239041,1569572,3712775,1798703,6490,7962.9
2021-08-27,31090,11225,5623,5174,632,3250266,1575195,3743865,1803877,7122,7987.9
2021-08-28,0,5737,3054,2579,164,3256003,1578249,3743865,1806456,7286,7970.1
2021-08-29,0,2567,1409,1068,105,3258570,1579658,3743865,1807524,7391,7991.3
2021-08-30,11920,9551,4695,4496,638,3268121,1584353,3755785,1812020,8029,7930.4
2021-08-31,38226,8444,3982,4130,535,3276565,1588335,3794011,1816150,8564,7842.9
2021-09-01,8198,9181,4002,4675,674,3285746,1592337,3802209,1820825,9238,7914.9
2021-09-02,20580,8429,3941,4058,557,3294175,1596278,3822789,1824883,9795,7876.3
2021-09-03,37880,10816,5427,4959,585,3304991,1601705,3860669,1829842,10380,7817.9
2021-09-04,0,5353,2744,2425,195,3310344,1604449,3860669,1832267,10575,7763
2021-09-05,0,2308,1157,1072,81,3312652,1605606,3860669,1833339,10656,7726
2021-09-06,0,1215,540,608,64,3313867,1606146,3860669,1833947,10720,6535.1
2021-09-07,774,9427,5543,3493,522,3323294,1611689,3861443,1837440,11242,6675.6
2021-09-08,13400,8937,4700,3791,581,3332231,1616389,3874843,1841231,11823,6640.7
2021-09-09,8540,8662,4322,3792,678,3340893,1620711,3883383,1845023,12501,6674
2021-09-10,31420,10765,6004,4516,458,3351658,1626715,3914803,1849539,12959,6666.7
2021-09-11,0,5942,3290,2496,175,3357600,1630005,3914803,1852035,13134,6750.9
2021-09-12,0,2178,1133,959,83,3359778,1631138,3914803,1852994,13217,6732.3
2021-09-13,2730,8615,4732,3526,482,3368393,1635870,3917533,1856520,13699,7789.4
2021-09-14,13046,7840,4203,3235,505,3376233,1640073,3930579,1859755,14204,7562.7
2021-09-15,11222,7364,3820,3191,462,3383597,1643893,3941801,1862946,14666,7338
2021-09-16,14200,7314,3981,2958,452,3390911,1647874,3956001,1865904,15118,7145.4
2021-09-17,14570,8640,4927,3477,410,3399551,1652801,3970571,1869381,15528,6841.9
2021-09-18,0,4936,2735,2011,206,3404487,1655536,3970571,1871392,15734,6698.1
2021-09-19,0,1735,1000,647,88,3406222,1656536,3970571,1872039,15822,6634.9
2021-09-20,2916,7238,4184,2692,526,3413460,1660720,3973487,1874731,16348,6438.1
2021-09-21,15010,6263,3653,2239,484,3419723,1664373,3988497,1876970,16832,6212.9
2021-09-22,3359,6295,3533,2314,534,3426018,1667906,3991856,1879284,17366,6060.1
2021-09-23,5560,6685,3388,2461,950,3432703,1671294,3997416,1881745,18316,5970.3
2021-09-24,10570,11055,4545,3071,3530,3443758,1675839,4007986,1884816,21846,6315.3
2021-09-25,0,5882,2245,1546,2094,3449640,1678084,4007986,1886362,23940,6450.4
2021-09-26,0,2242,915,561,763,3451882,1678999,4007986,1886923,24703,6522.9
2021-09-27,2090,11413,2498,2657,6326,3463295,1681497,4010076,1889580,31029,7119.3
2021-09-28,13230,10289,2714,2299,5348,3473584,1684211,4023306,1891879,36377,7694.4
2021-09-29,19930,11079,3312,2396,5511,3484663,1687523,4043236,1894275,41888,8377.9
2021-09-30,40280,10544,3188,2261,5285,3495207,1690711,4083516,1896536,47173,8929.1
2021-10-01,12290,10825,4068,2720,4188,3506032,1694779,4095806,1899256,51361,8896.3
2021-10-02,0,5153,2199,1338,1644,3511185,1696978,4095806,1900594,53005,8792.1
2021-10-03,0,1885,882,468,538,3513070,1697860,4095806,1901062,53543,8741.1
2021-10-04,8544,11128,3052,2306,5961,3524198,1700912,4104350,1903368,59504,8700.4
2021-10-05,17770,11229,2869,2169,6352,3535427,1703781,4122120,1905537,65856,8834.7
2021-10-06,8378,12536,3001,2414,7301,3547963,1706782,4130498,1907951,73157,9042.9
2021-10-07,41710,11550,2885,2457,6414,3559513,1709667,4172208,1910408,79571,9186.6
2021-10-08,12210,10625,3634,3011,4250,3570138,1713301,4184418,1913419,83821,9158
2021-10-09,0,4658,1942,1333,1467,3574796,1715243,4184418,1914752,85288,9087.3
2021-10-10,0,1836,679,561,597,3576632,1715922,4184418,1915313,85885,9080.3
2021-10-11,1790,10063,2707,2410,5185,3586695,1718629,4186208,1917723,91070,8928.1
2021-10-12,12142,10417,2340,2296,5975,3597112,1720969,4198350,1920019,97045,8812.1
2021-10-13,9964,9770,2537,2202,5217,3606882,1723506,4208314,1922221,102262,8417
2021-10-14,31580,8899,2333,2277,4478,3615781,1725839,4239894,1924498,106740,8038.3
2021-10-15,19210,9433,2876,2439,4376,3625214,1728715,4259104,1926937,111116,7868
2021-10-16,0,3797,1449,1180,1237,3629011,1730164,4259104,1928117,112353,7745
2021-10-17,0,1345,500,439,405,3630356,1730664,4259104,1928556,112758,7674.9
2021-10-18,17320,9027,2462,2399,4413,3639383,1733126,4276424,1930955,117171,7526.9
2021-10-19,3500,8455,2087,1988,4591,3647838,1735213,4279924,1932943,121762,7246.6
2021-10-20,8976,8707,2231,1894,4814,3656545,1737444,4288900,1934837,126576,7094.7
2021-10-21,40352,8259,2161,1990,4267,3664804,1739605,4329252,1936827,130843,7003.3
2021-10-22,15560,12138,2703,2487,7169,3676942,1742308,4344812,1939314,138012,7389.7
2021-10-23,0,6354,1284,1199,3911,3683296,1743592,4344812,1940513,141923,7755
2021-10-24,0,2035,467,477,1084,3685331,1744059,4344812,1940990,143007,7853.6
2021-10-25,2040,15675,2285,2769,10863,3701006,1746344,4346852,1943759,153870,8803.3
2021-10-26,46974,15044,2179,2402,10650,3716050,1748523,4393826,1946161,164520,9744.6
2021-10-27,26780,15244,2185,2401,10844,3731294,1750708,4420606,1948562,175364,10678.4
2021-10-28,45460,15249,2170,2559,10714,3746543,1752878,4466066,1951121,186078,11677
2021-10-29,31490,14620,2389,2454,9988,3761163,1755267,4497556,1953575,196066,12031.6
2021-10-30,0,5911,1135,1128,3688,3767074,1756402,4497556,1954703,199754,11968.3
2021-10-31,0,1960,460,446,1061,3769034,1756862,4497556,1955149,200815,11957.6
2021-11-01,17522,14280,2382,2509,9618,3783314,1759244,4515078,1957658,210433,11758.3
2021-11-02,54846,13771,2160,2527,9375,3797085,1761404,4569924,1960185,219808,11576.4
2021-11-03,11962,15665,2709,3583,9567,3812750,1764113,4581886,1963768,229375,11636.6
2021-11-04,55109,16307,2442,3989,10098,3829057,1766555,4636995,1967757,239473,11787.7
2021-11-05,24352,17344,2668,5018,9955,3846401,1769223,4661347,1972775,249428,12176.9
2021-11-06,8100,7850,1224,2922,3782,3854251,1770447,4669447,1975697,253210,12453.9
2021-11-07,0,2634,443,1201,1015,3856885,1770890,4669447,1976898,254225,12550.1
2021-11-08,26962,19912,2571,9127,8494,3876797,1773461,4696409,1986025,262719,13354.7
2021-11-09,27150,17975,2033,7866,8222,3894772,1775494,4723559,1993891,270941,13955.3
2021-11-10,21710,18278,1815,7854,8755,3913050,1777309,4745269,2001745,279696,14328.6
2021-11-11,44862,15873,1730,6651,7631,3928923,1779039,4790131,2008396,287327,14266.6
2021-11-12,33536,19847,2354,7895,9778,3948770,1781393,4823667,2016291,297105,14624.1
2021-11-13,300,10002,1119,4892,4077,3958772,1782512,4823967,2021183,301182,14931.6
2021-11-14,0,2384,364,972,1034,3961156,1782876,4823967,2022155,302216,14895.9
2021-11-15,16650,15784,1897,5929,8093,3976940,1784773,4840617,2028084,310309,14306.1
2021-11-16,17074,14975,1714,5213,8202,3991915,1786487,4857691,2033297,318511,13877.6
2021-11-17,39160,16108,1858,5499,8911,4008023,1788345,4896851,2038796,327422,13567.6
2021-11-18,31770,17990,1922,5512,10696,4026013,1790267,4928621,2044308,338118,13870
2021-11-19,30316,21861,2152,6198,13620,4047874,1792419,4958937,2050506,351738,14157.7
2021-11-20,0,10068,1012,3258,5835,4057942,1793431,4958937,2053764,357573,14167.1
2021-11-21,0,2785,324,822,1642,4060727,1793755,4958937,2054586,359215,14224.4
2021-11-22,8866,18523,1831,4342,12477,4079250,1795586,4967803,2058928,371692,14615.7
2021-11-23,42560,18908,1824,4694,12561,4098158,1797410,5010363,2063622,384253,15177.6
2021-11-24,360,14788,1539,4341,9023,4112946,1798949,5010723,2067963,393276,14989
2021-11-25,0,63,5,20,38,4113009,1798954,5010723,2067983,393314,12428
2021-11-26,4720,9538,1708,1902,5974,4122547,1800662,5015443,2069885,399288,10667.6
2021-11-27,0,8076,2177,1625,4343,4130623,1802839,5015443,2071510,403631,10383
2021-11-28,0,2712,874,475,1367,4133335,1803713,5015443,2071985,404998,10372.6
2021-11-29,13055,19547,6319,3066,10279,4152882,1810032,5028498,2075051,415277,10518.9
2021-11-30,41626,20743,6190,3581,11141,4173625,1816222,5070124,2078632,426418,10781
2021-12-01,23840,20974,6304,3699,11083,4194599,1822526,5093964,2082331,437501,11664.7
2021-12-02,24960,21573,5367,4091,12261,4216172,1827893,5118924,2086422,449762,14737.6
2021-12-03,32220,21812,6266,4122,11524,4237984,1834159,5151144,2090544,461286,16491
2021-12-04,0,10019,3185,1827,5041,4248003,1837344,5151144,2092371,466327,16768.6
2021-12-05,0,2613,841,479,1289,4250616,1838185,5151144,2092850,467616,16754.4
2021-12-06,16030,18999,5294,3071,10747,4269615,1843479,5167174,2095921,478363,16676.1
2021-12-07,25144,18056,4626,3148,10409,4287671,1848105,5192318,2099069,488772,16292.3
2021-12-08,14640,18593,4937,3370,10401,4306264,1853042,5206958,2102439,499173,15952.1
2021-12-09,57502,18665,4175,3568,11023,4324929,1857217,5264460,2106007,510196,15536.7
2021-12-10,21460,19515,5061,3341,11159,4344444,1862278,5285920,2109348,521355,15208.6
2021-12-11,100,9028,2603,1656,4809,4353472,1864881,5286020,2111004,526164,15067
2021-12-12,0,2829,620,504,1703,4356301,1865501,5286020,2111508,527867,15097.9
2021-12-13,28550,15443,3287,2699,9573,4371744,1868788,5314570,2114207,537440,14589.9
2021-12-14,13570,15346,3367,2838,9245,4387090,1872155,5328140,2117045,546685,14202.7
2021-12-15,14940,13851,2996,2702,8248,4400941,1875151,5343080,2119747,554933,13525.3
2021-12-16,27240,14261,2057,2912,9382,4415202,1877208,5370320,2122659,564315,12896.1
2021-12-17,37110,15833,2651,3022,10179,4431035,1879859,5407430,2125681,574494,12370.1
2021-12-18,0,7785,1682,1551,4582,4438820,1881541,5407430,2127232,579076,12192.6
2021-12-19,0,2809,396,602,1801,4441629,1881937,5407430,2127834,580877,12189.7
2021-12-20,16320,17390,3135,3189,11105,4459019,1885072,5423750,2131023,591982,12467.9
2021-12-21,26300,17222,2865,3313,11041,4476241,1887937,5450050,2134336,603023,12735.9
2021-12-22,24134,16874,2870,3407,10634,4493115,1890807,5474184,2137743,613657,13167.7
2021-12-23,11620,12022,1915,2514,7653,4505137,1892722,5485804,2140257,621310,12847.9
2021-12-24,0,2609,425,627,1589,4507746,1893147,5485804,2140884,622899,10958.7
2021-12-25,0,10,2,0,7,4507756,1893149,5485804,2140884,622906,9848
2021-12-26,0,2345,408,536,1393,4510101,1893557,5485804,2141420,624299,9781.7
2021-12-27,0,12394,2385,2606,7365,4522495,1895942,5485804,2144026,631664,9068
2021-12-28,42490,13662,2736,2953,8024,4536157,1898678,5528294,2146979,639688,8559.4
2021-12-29,9052,14056,2651,3259,8157,4550213,1901329,5537346,2150238,647845,8156.9
2021-12-30,300,14220,2630,3292,8345,4564433,1903959,5537646,2153530,656190,8470.9
2021-12-31,0,3463,595,800,2092,4567896,1904554,5537646,2154330,658282,8592.9
2022-01-01,0,636,85,123,427,4568532,1904639,5537646,2154453,658709,8682.3
2022-01-02,0,2064,435,485,1159,4570596,1905074,5537646,2154938,659868,8642.1
2022-01-03,0,10814,2285,2356,6250,4581410,1907359,5537646,2157294,666118,8416.4
2022-01-04,25080,12251,2349,2813,7159,4593661,1909708,5562726,2160107,673277,8214.9
2022-01-05,0,8405,1623,1999,4825,4602066,1911331,5562726,2162106,678102,7407.6
